0 0 0 0 0 0 0 0 0 0 0 0 0 0 0 0 0 0 0 0 0 0 0 0 0 0 0 0 0 0 0 0 0 0 0 0 0 0 0 0 0 0 0 0 0 0 0 0 0 0 0 0 0 0 0 0 0 0 0 0 0 0 0 0
0 0 0 0 0 0 0 0 0 0 0 0 0 0 0 0 0 0 0 0 0 0 0 0 0 0 0 0 0 0 0 0 0 0 0 0 0 0 0 0 0 0 0 0 0 0 0 0 0 0 0 0 0 0 0 0 0 0 0 0 0 0 0 0
0 0 0 0 0 0 0 0 0 0 0 0 0 0 0 0 0 0 0 0 0 0 0 0 0 0 0 0 0 0 0 0 0 0 0 0 0 0 0 0 0 0 0 0 0 0 0 0 0 0 0 0 0 0 0 0 0 0 0 0 0 0 0 0
0 0 58 58 100 241 0 0 0 0 0 0 0 0 0 0 0 0 0 0 0 0 0 0 0 0 0 0 0 0 241 241 0 0 0 0 0 0 0 0 0 0 0 0 0 0 0 0 0 0 0 0 0 0 0 0 0 0 0 0 0 0 0 0
0 242 100 100 237 237 0 0 0 0 0 0 0 0 0 0 0 0 0 0 0 0 0 0 0 0 0 0 0 0 245 245 241 58 0 0 0 0 0 0 0 235 235 0 0 0 0 0 0 0 0 0 58 100 0 0 0 0 0 0 0 0 0 0
0 100 59 237 237 0 0 241 241 245 241 241 237 241 0 0 241 237 100 100 100 0 0 242 0 0 58 0 0 0 242 235 235 241 100 100 58 0 237 241 0 237 235 235 58 0 241 242 242 0 0 240 241 241 0 237 241 245 0 237 245 0 0 100
0 0 241 241 241 237 0 0 0 245 58 237 0 241 235 0 245 237 241 237 58 242 0 242 245 241 58 100 0 0 241 235 0 235 242 235 241 0 0 241 0 237 241 235 241 237 241 235 235 0 237 245 0 0 237 241 241 237 245 237 245 241 0 241
0 0 0 0 100 242 237 0 0 58 237 0 0 241 235 0 245 237 245 237 0 242 100 100 241 245 235 100 0 0 239 235 0 235 241 235 245 245 237 100 0 242 58 242 58 237 241 235 237 100 237 245 245 0 237 242 0 237 245 237 245 237 241 100
0 0 0 0 58 100 58 0 0 58 237 0 0 241 245 245 241 0 245 237 0 241 0 0 0 245 235 0 58 100 58 235 234 241 241 0 235 241 100 58 0 241 237 241 241 237 241 242 100 100 237 241 0 0 237 242 237 237 242 237 100 0 237 241
0 241 242 241 241 237 58 0 0 241 58 0 0 0 241 242 237 0 241 241 242 0 0 0 0 245 235 0 0 58 239 241 58 0 0 0 235 241 241 0 0 245 0 237 242 0 237 242 241 0 235 237 241 241 0 237 241 242 0 237 100 0 237 241
0 0 0 0 0 0 58 0 0 0 0 0 0 0 0 0 0 0 0 0 0 0 0 0 0 0 0 0 0 0 0 0 58 0 0 0 0 0 0 0 0 0 0 0 0 0 0 0 0 0 0 0 0 0 0 0 0 0 0 0 58 0 0 0
0 0 0 0 0 0 58 0 0 0 0 0 0 0 0 0 0 0 0 0 0 0 0 0 0 0 0 0 0 0 0 0 58 0 0 0 0 0 0 0 0 0 0 0 0 0 0 0 0 0 0 0 0 0 0 0 0 0 0 0 58 0 0 0
